,Sequence,H_Count,C_Count,N_Count,O_Count,S_Count,TotalAtoms_Count
0,MGTSSGSGETAE,92,41,12,22,1,168
1,GTSSGSGETAEK,95,42,13,22,0,172
2,TSSGSGETAEKL,103,46,13,23,0,185
3,SSGSGETAEKLT,103,46,13,23,0,185
4,SGSGETAEKLTD,101,47,13,24,0,185
5,GSGETAEKLTDG,95,46,13,23,0,177
6,SGETAEKLTDGT,103,48,13,24,0,188
7,GETAEKLTDGTE,103,50,13,25,0,191
8,ETAEKLTDGTEA,105,51,13,25,0,194
9,TAEKLTDGTEAQ,106,51,14,24,0,195
10,AEKLTDGTEAQV,104,52,14,23,0,193
11,EKLTDGTEAQVS,108,52,14,24,0,198
12,KLTDGTEAQVSI,110,53,14,23,0,200
13,LTDGTEAQVSIG,99,49,13,22,0,183
14,TDGTEAQVSIGR,105,49,16,22,0,192
15,DGTEAQVSIGRS,103,48,16,22,0,189
16,GTEAQVSIGRSL,107,50,16,21,0,194
17,TEAQVSIGRSLE,113,53,16,23,0,205
18,EAQVSIGRSLES,111,52,16,23,0,202
19,AQVSIGRSLEST,113,51,16,22,0,202
20,QVSIGRSLESTS,117,51,16,23,0,207
21,VSIGRSLESTSE,116,51,15,24,0,206
22,SIGRSLESTSEL,118,52,15,25,0,210
23,IGRSLESTSELQ,119,54,16,25,0,214
24,GRSLESTSELQP,117,53,16,24,0,210
25,RSLESTSELQPK,128,57,17,25,0,227
26,SLESTSELQPKT,122,55,14,25,0,216
27,LESTSELQPKTF,124,61,14,24,0,223
28,ESTSELQPKTFE,122,60,14,25,0,221
29,STSELQPKTFEH,124,61,16,24,0,225
30,TSELQPKTFEHQ,125,63,17,24,0,229
31,SELQPKTFEHQE,123,64,17,25,0,229
32,ELQPKTFEHQET,125,65,17,25,0,232
33,LQPKTFEHQETR,133,66,20,24,0,243
34,QPKTFEHQETRL,133,66,20,24,0,243
35,PKTFEHQETRLN,131,65,20,24,0,240
36,KTFEHQETRLNG,125,62,20,24,0,231
37,TFEHQETRLNGG,114,58,19,23,0,214
38,FEHQETRLNGGH,114,60,21,23,0,218
39,EHQETRLNGGHN,111,55,22,24,0,212
40,HQETRLNGGHNG,105,52,22,22,0,201
41,QETRLNGGHNGL,105,52,20,22,0,199
42,ETRLNGGHNGLG,98,49,19,21,0,187
43,TRLNGGHNGLGA,94,47,19,19,0,179
44,RLNGGHNGLGAG,86,45,19,18,0,168
45,LNGGHNGLGAGG,72,41,16,17,0,146
46,NGGHNGLGAGGQ,71,40,17,17,0,145
47,GGHNGLGAGGQP,72,41,16,16,0,145
48,GHNGLGAGGQPG,72,41,16,16,0,145
49,HNGLGAGGQPGS,78,42,16,17,0,153
50,NGLGAGGQPGSN,75,40,15,17,0,147
51,"GLGAGGQPGSN",67,36,13,15,0,131
52,"LGAGGQPGSN
",64,34,12,14,0,124
53,"GAGGQPGSN
G",56,30,12,13,0,111
54,"AGGQPGSN
GA",58,31,12,13,0,114
55,"GGQPGSN
GAA",58,31,12,13,0,114
56,"GQPGSN
GAAL",66,35,12,14,0,127
57,"QPGSN
GAALP",72,38,12,14,0,136
58,"PGSN
GAALPG",65,35,11,13,0,124
59,"GSN
GAALPGL",67,36,11,14,0,128
60,"SN
GAALPGLS",73,37,11,15,0,136
61,"N
GAALPGLSD",71,38,11,16,0,136
62,"
GAALPGLSDT",74,38,10,16,0,138
63,"
GAALPGLSDTG",77,40,11,17,0,145
64,GAALPGLSDTGG,80,42,12,18,0,152
65,AALPGLSDTGGM,88,45,12,19,1,165
66,ALPGLSDTGGMP,92,47,12,19,1,171
67,LPGLSDTGGMPG,90,46,12,19,1,168
68,PGLSDTGGMPGQ,89,45,13,19,1,167
69,GLSDTGGMPGQF,91,49,13,19,1,173
70,LSDTGGMPGQFG,91,49,13,19,1,173
71,SDTGGMPGQFGV,89,48,13,18,1,169
72,DTGGMPGQFGVG,83,47,13,17,1,161
73,TGGMPGQFGVGQ,86,48,14,16,1,165
74,GGMPGQFGVGQL,86,50,14,16,1,167
75,GMPGQFGVGQLQ,93,53,15,17,1,179
76,MPGQFGVGQLQE,99,56,15,19,1,190
77,PGQFGVGQLQEQ,98,56,16,19,0,189
78,GQFGVGQLQEQL,100,57,16,20,0,193
79,QFGVGQLQEQLG,100,57,16,20,0,193
80,FGVGQLQEQLGV,99,57,15,19,0,190
81,GVGQLQEQLGVS,97,51,15,20,0,183
82,VGQLQEQLGVSG,97,51,15,20,0,183
83,GQLQEQLGVSGK,102,52,16,21,0,191
84,QLQEQLGVSGKG,102,52,16,21,0,191
85,LQEQLGVSGKGK,106,53,16,21,0,196
86,QEQLGVSGKGKE,104,52,16,22,0,194
87,EQLGVSGKGKED,101,51,15,23,0,190
88,QLGVSGKGKEDT,103,50,15,22,0,190
89,LGVSGKGKEDTL,104,51,14,22,0,191
90,GVSGKGKEDTLP,102,50,14,21,0,187
91,VSGKGKEDTLPH,110,54,16,22,0,202
92,SGKGKEDTLPHS,110,52,16,23,0,201
93,GKGKEDTLPHSS,110,52,16,23,0,201
94,KGKEDTLPHSSL,118,56,16,24,0,214
95,GKEDTLPHSSLS,113,53,15,24,0,205
96,KEDTLPHSSLSS,119,54,15,25,0,213
97,EDTLPHSSLSSP,114,53,14,24,0,205
98,DTLPHSSLSSPS,114,51,14,23,0,202
99,TLPHSSLSSPSR,124,53,17,22,0,216
100,LPHSSLSSPSRP,122,54,17,21,0,214
101,PHSSLSSPSRPG,114,50,17,20,0,201
102,HSSLSSPSRPGP,114,50,17,20,0,201
103,SSLSSPSRPGPA,108,47,15,19,0,189
104,SLSSPSRPGPAQ,109,49,16,19,0,193
105,LSSPSRPGPAQV,109,51,16,18,0,194
106,SSPSRPGPAQVS,107,48,16,18,0,189
107,SPSRPGPAQVSP,107,50,16,17,0,190
108,PSRPGPAQVSPS,107,50,16,17,0,190
109,SRPGPAQVSPSP,107,50,16,17,0,190
110,RPGPAQVSPSPK,112,53,17,17,0,199
111,PGPAQVSPSPKT,106,51,14,17,0,188
112,GPAQVSPSPKTS,106,49,14,18,0,187
113,PAQVSPSPKTSS,112,50,14,19,0,195
114,AQVSPSPKTSSG,106,47,14,19,0,186
115,"QVSPSPKTSSG",101,44,13,18,0,176
116,"VSPSPKTSSG
",91,39,11,16,0,157
117,"SPSPKTSSG
Q",92,39,12,17,0,160
118,"PSPKTSSG
QA",88,39,12,16,0,155
119,"SPKTSSG
QAK",93,40,13,17,0,163
120,"PKTSSG
QAKS",93,40,13,17,0,163
121,"KTSSG
QAKSG",87,37,13,17,0,154
122,"TSSG
QAKSGT",84,35,12,17,0,148
123,"SSG
QAKSGTG",76,33,12,16,0,137
124,"SG
QAKSGTGP",76,35,12,15,0,138
125,"G
QAKSGTGPR",84,38,15,15,0,152
126,"
QAKSGTGPRA",86,39,15,15,0,155
127,"
QAKSGTGPRAQ",96,44,17,17,0,174
128,QAKSGTGPRAQP,105,49,18,18,0,190
129,AKSGTGPRAQPK,109,50,18,18,0,195
130,KSGTGPRAQPKT,115,51,18,19,0,203
131,SGTGPRAQPKTS,110,48,17,19,0,194
132,GTGPRAQPKTSG,104,47,17,18,0,186
133,TGPRAQPKTSGP,110,50,17,18,0,195
134,GPRAQPKTSGPV,108,51,17,17,0,193
135,PRAQPKTSGPVA,110,52,17,17,0,196
136,RAQPKTSGPVAS,110,50,17,18,0,195
137,AQPKTSGPVASK,107,50,15,18,0,190
138,QPKTSGPVASKT,113,51,15,19,0,198
139,PKTSGPVASKTG,106,48,14,18,0,186
140,KTSGPVASKTGA,102,46,14,18,0,180
141,TSGPVASKTGAA,93,43,13,17,0,166
142,SGPVASKTGAAP,91,44,13,16,0,164
143,GPVASKTGAAPA,87,44,13,15,0,159
144,PVASKTGAAPAG,87,44,13,15,0,159
145,VASKTGAAPAGP,87,44,13,15,0,159
146,ASKTGAAPAGPG,81,41,13,15,0,150
147,SKTGAAPAGPGT,87,42,13,16,0,158
148,KTGAAPAGPGTS,87,42,13,16,0,158
149,TGAAPAGPGTSK,87,42,13,16,0,158
150,GAAPAGPGTSKP,85,43,13,15,0,156
151,AAPAGPGTSKPA,87,44,13,15,0,159
152,APAGPGTSKPAK,96,47,14,16,0,173
153,PAGPGTSKPAKT,102,48,14,17,0,181
154,AGPGTSKPAKTP,102,48,14,17,0,181
155,GPGTSKPAKTPG,100,47,14,17,0,178
156,PGTSKPAKTPGP,106,50,14,17,0,187
157,GTSKPAKTPGPG,100,47,14,17,0,178
158,TSKPAKTPGPGS,106,48,14,18,0,186
159,SKPAKTPGPGSG,98,46,14,17,0,175
160,KPAKTPGPGSGQ,99,48,15,17,0,179
161,PAKTPGPGSGQT,96,46,14,17,0,173
162,AKTPGPGSGQTK,101,47,15,18,0,181
163,KTPGPGSGQTKA,101,47,15,18,0,181
164,TPGPGSGQTKAP,96,46,14,17,0,173
165,PGPGSGQTKAPG,88,44,14,16,0,162
166,GPGSGQTKAPGQ,89,44,15,17,0,165
167,PGSGQTKAPGQA,91,45,15,17,0,168
168,GSGQTKAPGQAG,85,42,15,17,0,159
169,SGQTKAPGQAGA,87,43,15,17,0,162
170,GQTKAPGQAGAG,81,42,15,16,0,154
171,QTKAPGQAGAGK,92,46,16,17,0,171
172,TKAPGQAGAGKA,87,44,15,16,0,162
173,KAPGQAGAGKAG,79,42,15,15,0,151
174,APGQAGAGKAGP,74,41,14,14,0,143
175,PGQAGAGKAGPV,78,43,14,14,0,149
176,GQAGAGKAGPVT,80,42,14,15,0,151
177,QAGAGKAGPVTV,86,45,14,15,0,160
178,AGAGKAGPVTVS,85,43,13,15,0,156
179,"GAGKAGPVTVS",80,40,12,14,0,146
180,"AGKAGPVTVS
",77,38,11,13,0,139
181,"GKAGPVTVS
R",89,41,14,14,0,158
182,"KAGPVTVS
RG",89,41,14,14,0,158
183,"AGPVTVS
RGP",84,40,13,13,0,150
184,"GPVTVS
RGPT",90,41,13,14,0,158
185,"PVTVS
RGPTP",96,44,13,14,0,167
186,"VTVS
RGPTPP",96,44,13,14,0,167
187,"TVS
RGPTPPP",96,44,13,14,0,167
188,"VS
RGPTPPPP",94,45,13,13,0,165
189,"S
RGPTPPPPK",99,46,14,14,0,173
190,"
RGPTPPPPKP",99,48,14,13,0,174
191,"
RGPTPPPPKPR",116,54,18,15,0,203
192,RGPTPPPPKPRG,119,56,19,16,0,210
193,GPTPPPPKPRGS,111,53,16,16,0,196
194,PTPPPPKPRGSR,125,57,19,17,0,218
195,TPPPPKPRGSRP,125,57,19,17,0,218
196,PPPPKPRGSRPG,117,55,19,16,0,207
197,PPPKPRGSRPGP,117,55,19,16,0,207
198,PPKPRGSRPGPK,122,56,20,17,0,215
199,PKPRGSRPGPKT,124,55,20,18,0,217
200,KPRGSRPGPKTG,118,52,20,18,0,208
201,PRGSRPGPKTGG,107,48,19,17,0,191
202,RGSRPGPKTGGP,107,48,19,17,0,191
203,GSRPGPKTGGPS,99,45,16,17,0,177
204,SRPGPKTGGPSG,99,45,16,17,0,177
205,RPGPKTGGPSGK,104,48,17,17,0,186
206,PGPKTGGPSGKT,98,46,14,17,0,175
207,GPKTGGPSGKTA,94,44,14,17,0,169
208,PKTGGPSGKTAP,100,47,14,17,0,178
209,KTGGPSGKTAPG,94,44,14,17,0,169
210,TGGPSGKTAPGS,89,41,13,17,0,160
211,GGPSGKTAPGSA,83,40,13,16,0,152
212,GPSGKTAPGSAG,83,40,13,16,0,152
213,PSGKTAPGSAGA,85,41,13,16,0,155
214,SGKTAPGSAGAK,90,42,14,17,0,163
215,GKTAPGSAGAKT,92,43,14,17,0,166
216,KTAPGSAGAKTS,98,44,14,18,0,174
217,TAPGSAGAKTSS,93,41,13,18,0,165
218,APGSAGAKTSSG,85,39,13,17,0,154
219,PGSAGAKTSSGE,89,41,13,19,0,162
220,GSAGAKTSSGEA,85,39,13,19,0,156
221,SAGAKTSSGEAK,96,43,14,20,0,173
222,AGAKTSSGEAKT,98,44,14,20,0,176
223,GAKTSSGEAKTP,102,46,14,20,0,182
224,AKTSSGEAKTPS,108,47,14,21,0,190
225,KTSSGEAKTPSG,106,46,14,21,0,187
226,TSSGEAKTPSGT,103,44,13,21,0,181
227,SSGEAKTPSGTS,101,43,13,21,0,178
228,SGEAKTPSGTSP,101,45,13,20,0,179
229,GEAKTPSGTSPK,106,48,14,20,0,188
230,EAKTPSGTSPKV,112,51,14,20,0,197
231,AKTPSGTSPKVG,106,48,14,18,0,186
232,KTPSGTSPKVGK,115,51,15,19,0,200
233,TPSGTSPKVGKP,110,50,14,18,0,192
234,PSGTSPKVGKPA,104,49,14,17,0,184
235,SGTSPKVGKPAG,98,46,14,17,0,175
236,GTSPKVGKPAGA,94,46,14,16,0,170
237,TSPKVGKPAGAP,100,49,14,16,0,179
238,SPKVGKPAGAPG,92,47,14,15,0,168
239,PKVGKPAGAPGA,88,47,14,14,0,163
240,KVGKPAGAPGAE,88,47,14,16,0,165
241,VGKPAGAPGAEK,88,47,14,16,0,165
242,GKPAGAPGAEKS,88,45,14,17,0,164
243,"KPAGAPGAEKS",85,43,13,16,0,157
244,"PAGAPGAEKS
",71,37,11,14,0,133
245,"AGAPGAEKS
G",65,34,11,14,0,124
246,"GAPGAEKS
GP",69,36,11,14,0,130
247,"APGAEKS
GPP",75,39,11,14,0,139
248,"PGAEKS
GPPG",73,38,11,14,0,136
249,"GAEKS
GPPGV",73,38,11,14,0,136
250,"AEKS
GPPGVS",79,39,11,15,0,144
251,"EKS
GPPGVSS",83,39,11,16,0,149
252,"KS
GPPGVSSK",88,40,12,15,0,155
253,"S
GPPGVSSKP",83,39,11,14,0,147
254,"
GPPGVSSKPG",77,38,11,13,0,139
255,"
GPPGVSSKPGG",80,40,12,14,0,146
256,GPPGVSSKPGGS,89,43,13,16,0,161
257,PPGVSSKPGGSG,89,43,13,16,0,161
258,PGVSSKPGGSGP,89,43,13,16,0,161
259,GVSSKPGGSGPK,94,44,14,17,0,169
260,VSSKPGGSGPKA,96,45,14,17,0,172
261,SSKPGGSGPKAG,90,42,14,17,0,163
262,SKPGGSGPKAGK,95,45,15,17,0,172
263,KPGGSGPKAGKP,95,47,15,16,0,173
264,PGGSGPKAGKPG,84,43,14,15,0,156
265,GGSGPKAGKPGS,84,41,14,16,0,155
266,GSGPKAGKPGSG,84,41,14,16,0,155
267,SGPKAGKPGSGG,84,41,14,16,0,155
268,GPKAGKPGSGGA,80,41,14,15,0,150
269,PKAGKPGSGGAG,80,41,14,15,0,150
270,KAGKPGSGGAGP,80,41,14,15,0,150
271,AGKPGSGGAGPS,75,38,13,15,0,141
272,GKPGSGGAGPSG,73,37,13,15,0,138
273,KPGSGGAGPSGS,79,38,13,16,0,146
274,PGSGGAGPSGSP,74,37,12,15,0,138
275,GSGGAGPSGSPG,68,34,12,15,0,129
276,SGGAGPSGSPGK,79,38,13,16,0,146
277,GGAGPSGSPGKP,79,40,13,15,0,147
278,GAGPSGSPGKPG,79,40,13,15,0,147
279,AGPSGSPGKPGT,87,42,13,16,0,158
280,GPSGSPGKPGTK,96,45,14,17,0,172
281,PSGSPGKPGTKG,96,45,14,17,0,172
282,SGSPGKPGTKGP,96,45,14,17,0,172
283,GSPGKPGTKGPK,101,48,15,17,0,181
284,SPGKPGTKGPKG,101,48,15,17,0,181
285,PGKPGTKGPKGA,97,48,15,16,0,176
286,GKPGTKGPKGAK,102,49,16,17,0,184
287,KPGTKGPKGAKG,102,49,16,17,0,184
288,PGTKGPKGAKGP,97,48,15,16,0,176
289,GTKGPKGAKGPK,102,49,16,17,0,184
290,TKGPKGAKGPKG,102,49,16,17,0,184
291,KGPKGAKGPKGA,96,48,16,16,0,176
292,GPKGAKGPKGAK,96,48,16,16,0,176
293,PKGAKGPKGAKG,96,48,16,16,0,176
294,KGAKGPKGAKGP,96,48,16,16,0,176
295,GAKGPKGAKGPK,96,48,16,16,0,176
296,AKGPKGAKGPKG,96,48,16,16,0,176
297,KGPKGAKGPKGP,100,50,16,16,0,182
298,GPKGAKGPKGPK,100,50,16,16,0,182
299,PKGAKGPKGPKG,100,50,16,16,0,182
300,KGAKGPKGPKGA,96,48,16,16,0,176
301,GAKGPKGPKGAK,96,48,16,16,0,176
302,AKGPKGPKGAKG,96,48,16,16,0,176
303,KGPKGPKGAKGA,96,48,16,16,0,176
304,GPKGPKGAKGAK,96,48,16,16,0,176
305,PKGPKGAKGAKG,96,48,16,16,0,176
306,KGPKGAKGAKGP,96,48,16,16,0,176
307,"GPKGAKGAKGP",82,42,14,14,0,152
308,"PKGAKGAKGP
",79,40,13,13,0,145
309,"KGAKGAKGP
K",84,41,14,14,0,153
310,"GAKGAKGP
KG",73,37,13,13,0,136
311,"AKGAKGP
KGA",75,38,13,13,0,139
312,"KGAKGP
KGAK",84,41,14,14,0,153
313,"GAKGP
KGAKG",73,37,13,13,0,136
314,"AKGP
KGAKGP",79,40,13,13,0,145
315,"KGP
KGAKGPK",88,43,14,14,0,159
316,"GP
KGAKGPKG",77,39,13,13,0,142
317,"P
KGAKGPKGP",83,42,13,13,0,151
318,"
KGAKGPKGPK",88,43,14,14,0,159
319,"
KGAKGPKGPKG",91,45,15,15,0,166
320,KGAKGPKGPKGA,96,48,16,16,0,176
321,GAKGPKGPKGAQ,92,47,16,16,0,171
322,AKGPKGPKGAQG,92,47,16,16,0,171
323,KGPKGPKGAQGP,96,49,16,16,0,177
324,GPKGPKGAQGPK,96,49,16,16,0,177
325,PKGPKGAQGPKG,96,49,16,16,0,177
326,KGPKGAQGPKGP,96,49,16,16,0,177
327,GPKGAQGPKGPK,96,49,16,16,0,177
328,PKGAQGPKGPKG,96,49,16,16,0,177
329,KGAQGPKGPKGP,96,49,16,16,0,177
330,GAQGPKGPKGPK,96,49,16,16,0,177
331,AQGPKGPKGPKG,96,49,16,16,0,177
332,QGPKGPKGPKGP,100,51,16,16,0,183
333,GPKGPKGPKGPK,104,52,16,16,0,188
334,PKGPKGPKGPKG,104,52,16,16,0,188
335,KGPKGPKGPKGP,104,52,16,16,0,188
336,GPKGPKGPKGPK,104,52,16,16,0,188
337,PKGPKGPKGPKG,104,52,16,16,0,188
338,KGPKGPKGPKGP,104,52,16,16,0,188
339,GPKGPKGPKGPK,104,52,16,16,0,188
340,PKGPKGPKGPKG,104,52,16,16,0,188
341,KGPKGPKGPKGP,104,52,16,16,0,188
342,GPKGPKGPKGPK,104,52,16,16,0,188
343,PKGPKGPKGPKG,104,52,16,16,0,188
344,KGPKGPKGPKGP,104,52,16,16,0,188
345,GPKGPKGPKGPK,104,52,16,16,0,188
346,PKGPKGPKGPKG,104,52,16,16,0,188
347,KGPKGPKGPKGP,104,52,16,16,0,188
348,GPKGPKGPKGPK,104,52,16,16,0,188
349,PKGPKGPKGPKG,104,52,16,16,0,188
350,KGPKGPKGPKGP,104,52,16,16,0,188
351,GPKGPKGPKGPK,104,52,16,16,0,188
352,PKGPKGPKGPKG,104,52,16,16,0,188
353,KGPKGPKGPKGP,104,52,16,16,0,188
354,GPKGPKGPKGPK,104,52,16,16,0,188
355,PKGPKGPKGPKG,104,52,16,16,0,188
356,KGPKGPKGPKGP,104,52,16,16,0,188
357,GPKGPKGPKGPK,104,52,16,16,0,188
358,PKGPKGPKGPKG,104,52,16,16,0,188
359,KGPKGPKGPKGP,104,52,16,16,0,188
360,GPKGPKGPKGPK,104,52,16,16,0,188
361,PKGPKGPKGPKG,104,52,16,16,0,188
362,KGPKGPKGPKGP,104,52,16,16,0,188
363,GPKGPKGPKGPK,104,52,16,16,0,188
364,PKGPKGPKGPKG,104,52,16,16,0,188
365,KGPKGPKGPKGP,104,52,16,16,0,188
366,GPKGPKGPKGPK,104,52,16,16,0,188
367,PKGPKGPKGPKG,104,52,16,16,0,188
368,KGPKGPKGPKGP,104,52,16,16,0,188
369,GPKGPKGPKGPK,104,52,16,16,0,188
370,PKGPKGPKGPKG,104,52,16,16,0,188
371,"KGPKGPKGPKG",95,47,15,15,0,172
372,"GPKGPKGPKG
",81,41,13,13,0,148
373,"PKGPKGPKG
P",87,44,13,13,0,157
374,"KGPKGPKG
PK",92,45,14,14,0,165
375,"GPKGPKG
PKG",81,41,13,13,0,148
376,"PKGPKG
PKGP",87,44,13,13,0,157
377,"KGPKG
PKGPK",92,45,14,14,0,165
378,"GPKG
PKGPKG",81,41,13,13,0,148
379,"PKG
PKGPKGP",87,44,13,13,0,157
380,"KG
PKGPKGPK",92,45,14,14,0,165
381,"G
PKGPKGPKG",81,41,13,13,0,148
382,"
PKGPKGPKGP",87,44,13,13,0,157
383,"
PKGPKGPKGPK",101,50,15,15,0,181
384,PKGPKGPKGPKG,104,52,16,16,0,188
385,KGPKGPKGPKGP,104,52,16,16,0,188
386,GPKGPKGPKGPK,104,52,16,16,0,188
387,PKGPKGPKGPKG,104,52,16,16,0,188
388,KGPKGPKGPKGP,104,52,16,16,0,188
389,GPKGPKGPKGPK,104,52,16,16,0,188
390,PKGPKGPKGPKG,104,52,16,16,0,188
391,KGPKGPKGPKGP,104,52,16,16,0,188
392,GPKGPKGPKGPK,104,52,16,16,0,188
393,PKGPKGPKGPKG,104,52,16,16,0,188
394,KGPKGPKGPKGP,104,52,16,16,0,188
395,GPKGPKGPKGPK,104,52,16,16,0,188
396,PKGPKGPKGPKG,104,52,16,16,0,188
397,KGPKGPKGPKGP,104,52,16,16,0,188
398,GPKGPKGPKGPK,104,52,16,16,0,188
399,PKGPKGPKGPKG,104,52,16,16,0,188
400,KGPKGPKGPKGP,104,52,16,16,0,188
401,GPKGPKGPKGPK,104,52,16,16,0,188
402,PKGPKGPKGPKG,104,52,16,16,0,188
403,KGPKGPKGPKGP,104,52,16,16,0,188
404,GPKGPKGPKGPK,104,52,16,16,0,188
405,PKGPKGPKGPKG,104,52,16,16,0,188
406,KGPKGPKGPKGP,104,52,16,16,0,188
407,GPKGPKGPKGPK,104,52,16,16,0,188
408,PKGPKGPKGPKG,104,52,16,16,0,188
409,KGPKGPKGPKGP,104,52,16,16,0,188
410,GPKGPKGPKGPK,104,52,16,16,0,188
411,PKGPKGPKGPKG,104,52,16,16,0,188
412,KGPKGPKGPKGP,104,52,16,16,0,188
413,GPKGPKGPKGPK,104,52,16,16,0,188
414,PKGPKGPKGPKG,104,52,16,16,0,188
415,KGPKGPKGPKGP,104,52,16,16,0,188
416,GPKGPKGPKGPK,104,52,16,16,0,188
417,PKGPKGPKGPKG,104,52,16,16,0,188
418,KGPKGPKGPKGP,104,52,16,16,0,188
419,GPKGPKGPKGPK,104,52,16,16,0,188
420,PKGPKGPKGPKG,104,52,16,16,0,188
421,KGPKGPKGPKGP,104,52,16,16,0,188
422,GPKGPKGPKGPK,104,52,16,16,0,188
423,PKGPKGPKGPKG,104,52,16,16,0,188
424,KGPKGPKGPKGP,104,52,16,16,0,188
425,GPKGPKGPKGPK,104,52,16,16,0,188
426,PKGPKGPKGPKG,104,52,16,16,0,188
427,KGPKGPKGPKGP,104,52,16,16,0,188
428,GPKGPKGPKGPK,104,52,16,16,0,188
429,PKGPKGPKGPKG,104,52,16,16,0,188
430,KGPKGPKGPKGP,104,52,16,16,0,188
431,GPKGPKGPKGPK,104,52,16,16,0,188
432,PKGPKGPKGPKG,104,52,16,16,0,188
433,KGPKGPKGPKGP,104,52,16,16,0,188
434,GPKGPKGPKGPK,104,52,16,16,0,188
